C 225,30,0
NO textures/north.png
SO textures/south.png
WE textures/west.png
EA textures/east.png
F 220, 100, 20





111111111111111111111111111111
100000000011000000000000000001
101100E00111000000000000000011
100100000000000000000000000011    11111111
100100000000000000000000000001     11111111
10010000000000000000000000000111111111111111111
11111111101100000111000000000000000000000000001     
11110111111111011100000010001111111111000000001
11110111111111011101010010000000000000000000001
11000000110101011100000010001111111111000000001                                  1 1
10000000000000000000000010001        1100000011                                 10101
10000000000000001101010010001        1111001111                                  1 1
1100000111010101111101111000111         1001
11110111 1110101 101111010001           1001
11111111 1111111 111111111111           1001
                                        1001                        1
                                111111111001111111111111111111
                                100000000001000000000000000001
                                101100000101000000000000000011
                                100100000000000000000000000011     11111111
                                100100000000000000000000000001     11111111
                                10010000000000000000000000000111111111111111111
                                11111111101100000111000000000000000000000000001     
                                11110111111111011100000010001111111111000000001
                                11110111111111011101010010000000000000000000001
                                11000000110101011100000010001111111111000000001                                  
                                10000000000000000000000010001        1100000011                                 
                                10000000000000001101010010001        1111111111                                   
                                1100000111010101111101111000111
                                11110111 1110101 101111010001
                                11111111 1111111 111111111111
                                                                                                1
                                111111