C 225,30,0
NO /Users/ayzahrao/Documents/cub3d/src/parsing/normalize_map.c
SO /Users/ayzahrao/Documents/cub3d/src/parsing/normalize_map.c
WE /Users/ayzahrao/Documents/cub3d/src/parsing/normalize_map.c 
EA /Users/ayzahrao/Documents/cub3d/src/parsing/normalize_map.c
F 220, 100, 20





111111111111111111111111111111
10E000000011000000000000000001
101100000111000000000000000011
10010000000000000000000000001     11111111
100100000000000000000000000001     11111111
10010000000000000000000000000111111111111111111
11111111101100000111000000000000000000000000001     
11110111111111011100000010001111111111000000001
11110111111111011101010010000000000000000000001
11000000110101011100000010001111111111000000001                                  1 1
10000000000000000000000010001        110000001                                  10101
10000000000000001101010010001          111111                                    1 1
1100000111010101111101111000111
11110111 1110101 101111010001
11111111 1111111 111111111111
                                                                1
111111


                                111111111111111111111111111111
                                100000000011000000000000000001
                                101100000111000000000000000011
                                10010000000000000000000000001     11111111
                                100100000000000000000000000001     11111111
                                10010000000000000000000000000111111111111111111
                                11111111101100000111000000000000000000000000001     
                                11110111111111011100000010001111111111000000001
                                11110111111111011101010010000000000000000000001
                                11000000110101011100000010001111111111000000001                                  1 1
                                10000000000000000000000010001        110000001                                  10101
                                10000000000000001101010010001          111111                                    1 1
                                1100000111010101111101111000111
                                11110111 1110101 101111010001
                                11111111 1111111 111111111111
                                                                                                1
                                111111