C 225,30,0
NO textures/north.png
SO textures/south.png
WE textures/west.png
EA textures/east.png
F 220, 100, 20

1111
10N1
1111