C 225,30,0
NO textures/north.png
SO textures/south.png
WE textures/west.png
EA textures/east.png
F 220, 100, 20

111111111111111111111111111111111111111111111111111
        1
       101
      10001
     1000001
    1000S0001
    111111111