C 225,30,0
NO /Users/ayzahrao/Documents/cub3d/src/parsing/normalize_map.c
SO /Users/ayzahrao/Documents/cub3d/src/parsing/normalize_map.c
WE /Users/ayzahrao/Documents/cub3d/src/parsing/normalize_map.c 
EA /Users/ayzahrao/Documents/cub3d/src/parsing/normalize_map.c
F 220,100,        20


111111111111
100000000001
100000000001
100000000001
100000000001
100S00000001
111110111111
    1001
111111011111
      1                     1
